sub_phylum	org_name_protein_id	org_name	stop_codon_pos	equal_to_cds	cassette_intron_start	intron_length_to_stop_codon	intron_length	first_exon_length	source
Otomorpha	ictalurus_punctatus_11	Ictalurus_punctatus	1104	False	1058	46	3166	110	datasets
Otomorpha	chanos_chanos_4	Chanos_chanos	1071	False	1070	1	3568	110	datasets
Otomorpha	sinocyclocheilus_rhinocerous_12	Sinocyclocheilus_rhinocerous	1215	False	1061	154	3449	110	datasets
Otomorpha	carassius_auratus_9	Carassius_auratus	1221	False	1073	148	3854	110	datasets
Otomorpha	denticeps_clupeoides_5	Denticeps_clupeoides	1041	False	1034	7	2629	110	datasets
Otomorpha	pygocentrus_nattereri_10	Pygocentrus_nattereri	1110	False	1064	46	2649	110	datasets
Otomorpha	pangasianodon_hypophthalmus_8	Pangasianodon_hypophthalmus	1128	False	1082	46	3348	110	datasets
Otomorpha	sinocyclocheilus_grahami_14	Sinocyclocheilus_grahami	1212	False	1064	148	3330	110	datasets
Otomorpha	danio_rerio_2	Danio_rerio	1092	False	1091	1	3580	110	datasets
Otomorpha	electrophorus_electricus_7	Electrophorus_electricus	1353	False	1070	283	2874	110	datasets
Otomorpha	tachysurus_fulvidraco_6	Tachysurus_fulvidraco	1119	False	1073	46	3493	110	datasets
Otomorpha	sinocyclocheilus_anshuiensis_13	Sinocyclocheilus_anshuiensis	1245	False	1091	154	4202	110	datasets
Otomorpha	astyanax_mexicanus_3	Astyanax_mexicanus	1140	False	1094	46	2791	110	datasets
Otomorpha	colossoma_macropomum_0	Colossoma_macropomum	1113	False	1067	46	2644	110	datasets
Otomorpha	puntigrus_tetrazona_16	Puntigrus_tetrazona	1101	False	1076	25	2440	110	datasets
Otomorpha	clupea_harengus_15	Clupea_harengus	1101	False	1079	22	3219	110	datasets
Euteleosteomorpha	salarias_fasciatus_18	Salarias_fasciatus	1068	False	1046	22	3855	110	datasets
Euteleosteomorpha	poecilia_mexicana_3	Poecilia_mexicana	1173	False	1151	22	2247	110	datasets
Euteleosteomorpha	xiphophorus_couchianus_28	Xiphophorus_couchianus	1164	False	1142	22	2227	110	datasets
Euteleosteomorpha	cottoperca_gobio_21	Cottoperca_gobio	1173	False	1157	16	2388	110	datasets
Euteleosteomorpha	cyprinodon_variegatus_41	Cyprinodon_variegatus	1128	False	1100	28	2533	110	datasets
Euteleosteomorpha	gouania_willdenowi_24	Gouania_willdenowi	1089	False	1052	37	2616	110	datasets
Euteleosteomorpha	poecilia_reticulata_47	Poecilia_reticulata	1176	False	1154	22	2262	110	datasets
Euteleosteomorpha	takifugu_rubripes_55	Takifugu_rubripes	1146	False	1124	22	2114	110	datasets
Euteleosteomorpha	notothenia_coriiceps_45	Notothenia_coriiceps	399	False	377	22	2886	110	datasets
Euteleosteomorpha	myripristis_murdjan_19	Myripristis_murdjan	1263	False	1151	112	2492	110	datasets
Euteleosteomorpha	betta_splendens_22	Betta_splendens	1188	False	1166	22	2274	110	datasets
Euteleosteomorpha	etheostoma_spectabile_11	Etheostoma_spectabile	1251	False	1154	97	2457	110	datasets
Euteleosteomorpha	salmo_salar_0	Salmo_salar	1119	False	1052	67	3553	110	datasets
Euteleosteomorpha	larimichthys_crocea_46	Larimichthys_crocea	1104	False	1082	22	2340	110	datasets
Euteleosteomorpha	lates_calcarifer_4	Lates_calcarifer	1299	False	1277	22	2434	110	datasets
Euteleosteomorpha	stegastes_partitus_49	Stegastes_partitus	1074	False	1052	22	2900	110	datasets
Euteleosteomorpha	fundulus_heteroclitus_43	Fundulus_heteroclitus	1134	False	1109	25	2476	110	datasets
Euteleosteomorpha	sparus_aurata_16	Sparus_aurata	1170	False	1148	22	2361	110	datasets
Euteleosteomorpha	anarrhichthys_ocellatus_12	Anarrhichthys_ocellatus	1185	False	1163	22	2355	110	datasets
Euteleosteomorpha	boleophthalmus_pectinirostris_35	Boleophthalmus_pectinirostris	1071	False	1049	22	1702	110	datasets
Euteleosteomorpha	xiphophorus_maculatus_52	Xiphophorus_maculatus	1068	False	1046	22	2231	110	datasets
Euteleosteomorpha	anabas_testudineus_29	Anabas_testudineus	1176	False	1154	22	2352	110	datasets
Euteleosteomorpha	mastacembelus_armatus_30	Mastacembelus_armatus	1125	False	1061	64	2371	110	datasets
Euteleosteomorpha	acanthochromis_polyacanthus_34	Acanthochromis_polyacanthus	1074	False	1052	22	2797	110	datasets
Euteleosteomorpha	haplochromis_burtoni_51	Haplochromis_burtoni	1161	False	1130	31	2535	110	datasets
Euteleosteomorpha	nothobranchius_furzeri_7	Nothobranchius_furzeri	1146	False	1124	22	2290	110	datasets
Euteleosteomorpha	paralichthys_olivaceus_38	Paralichthys_olivaceus	1173	False	1151	22	3148	110	datasets
Euteleosteomorpha	maylandia_zebra_54	Maylandia_zebra	1152	False	1130	22	2565	110	datasets
Euteleosteomorpha	labrus_bergylta_36	Labrus_bergylta	1191	False	1181	10	2684	110	datasets
Euteleosteomorpha	parambassis_ranga_1	Parambassis_ranga	1068	False	1046	22	2484	110	datasets
Euteleosteomorpha	sander_lucioperca_14	Sander_lucioperca	1182	False	1160	22	2494	110	datasets
Euteleosteomorpha	oryzias_latipes_9	Oryzias_latipes	1188	False	1148	40	2331	110	datasets
Euteleosteomorpha	archocentrus_centrarchus_15	Archocentrus_centrarchus	1095	False	1073	22	2644	110	datasets
Euteleosteomorpha	esox_lucius_44	Esox_lucius	1053	False	1031	22	2848	110	datasets
Euteleosteomorpha	monopterus_albus_37	Monopterus_albus	1134	False	1112	22	2353	110	datasets
Euteleosteomorpha	echeneis_naucrates_20	Echeneis_naucrates	1068	False	1046	22	2314	110	datasets
Euteleosteomorpha	sphaeramia_orbicularis_17	Sphaeramia_orbicularis	1101	False	1058	43	2376	110	datasets
Euteleosteomorpha	xiphophorus_hellerii_10	Xiphophorus_hellerii	1083	False	1061	22	2240	110	datasets
Euteleosteomorpha	poecilia_latipinna_2	Poecilia_latipinna	1182	False	1160	22	2261	110	datasets
Euteleosteomorpha	pundamilia_nyererei_53	Pundamilia_nyererei	1152	False	1130	22	2527	110	datasets
Euteleosteomorpha	hippocampus_comes_39	Hippocampus_comes	1230	False	1208	22	2622	110	datasets
Euteleosteomorpha	poecilia_formosa_50	Poecilia_formosa	1179	False	1157	22	2259	110	datasets
Euteleosteomorpha	oreochromis_niloticus_56	Oreochromis_niloticus	1152	False	1130	22	2580	110	datasets
Euteleosteomorpha	kryptolebias_marmoratus_40	Kryptolebias_marmoratus	1164	False	1142	22	2556	110	datasets
Euteleosteomorpha	oryzias_melastigma_5	Oryzias_melastigma	1167	False	1145	22	2212	110	datasets
Euteleosteomorpha	amphiprion_ocellaris_33	Amphiprion_ocellaris	1077	False	1055	22	2752	110	datasets
Euteleosteomorpha	seriola_dumerili_6	Seriola_dumerili	1086	False	1064	22	2494	110	datasets
Euteleosteomorpha	oreochromis_aureus_13	Oreochromis_aureus	1152	False	1130	22	2579	110	datasets
Euteleosteomorpha	perca_flavescens_23	Perca_flavescens	1215	False	1157	58	2378	110	datasets
Euteleosteomorpha	gadus_morhua_8	Gadus_morhua	1242	False	1175	67	3151	110	datasets
Euteleosteomorpha	astatotilapia_calliptera_31	Astatotilapia_calliptera	1161	False	1130	31	2571	110	datasets
Euteleosteomorpha	austrofundulus_limnaeus_42	Austrofundulus_limnaeus	1167	False	1145	22	2541	110	datasets
Euteleosteomorpha	seriola_lalandi_dorsalis_32	Seriola_lalandi_dorsalis	1185	False	1163	22	2481	110	datasets
Osteoglossomorpha	paramormyrops_kingsleyae_0	Paramormyrops_kingsleyae	1254	False	1133	121	2929	110	datasets
Osteoglossomorpha	scleropages_formosus_1	Scleropages_formosus	1239	False	1127	112	3412	110	datasets
Cladistia	erpetoichthys_calabaricus_0	Erpetoichthys_calabaricus	1173	False	1118	55	3662	110	datasets
Gymnophiona	geotrypetes_seraphini_2	Geotrypetes_seraphini	894	False	839	55	3065	110	datasets
Gymnophiona	microcaecilia_unicolor_0	Microcaecilia_unicolor	1116	False	929	187	2784	110	datasets
Gymnophiona	rhinatrema_bivittatum_1	Rhinatrema_bivittatum	1134	False	1031	103	4053	110	datasets
Caudata	ambystoma_mexicanum_0	Ambystoma_mexicanum	1068	False	1067	1	10340	110	datasets
Caudata	pleurodeles_waltl_1	Pleurodeles_waltl	1344	False	1193	151	3245	110	datasets
Anura	rana_temporaria_0	Rana_temporaria	1017	False	1007	10	3036	110	datasets
Anura	bufo_gargarizans_12	Bufo_gargarizans	1017	False	1010	7	2879	110	datasets
Anura	xenopus_laevis_18	Xenopus_laevis	1062	False	1010	52	3791	110	datasets
Anura	hyla_sarda_10	Hyla_sarda	1032	False	1007	25	3029	110	datasets
Anura	spea_bombifrons_11	Spea_bombifrons	1041	False	1016	25	2840	110	datasets
Anura	pyxicephalus_adspersus_3	Pyxicephalus_adspersus	1047	False	1022	25	2917	110	datasets
Anura	hyperolius_riggenbachi_7	Hyperolius_riggenbachi	1020	False	1010	10	3902	110	datasets
Anura	ranitomeya_imitator_6	Ranitomeya_imitator	1047	False	1010	37	2650	110	datasets
Anura	bufo_bufo_14	Bufo_bufo	720	False	713	7	3002	110	datasets
Anura	xenopus_tropicalis_1	Xenopus_tropicalis	1083	False	1037	46	2596	110	datasets
Anura	engystomops_pustulosus_4	Engystomops_pustulosus	1047	False	1022	25	2004	110	datasets
Anura	pelobates_fuscus_9	Pelobates_fuscus	1011	False	1010	1	2424	110	datasets
Anura	nanorana_parkeri_16	Nanorana_parkeri	1044	False	1019	25	3038	110	datasets
Anura	pseudophryne_corroboree_8	Pseudophryne_corroboree	1035	False	1016	19	3561	110	datasets
Lepidosauria	python_bivittatus_26	Python_bivittatus	1035	False	1034	1	2374	110	datasets
Lepidosauria	notechis_scutatus_22	Notechis_scutatus	1023	False	1022	1	2507	110	datasets
Lepidosauria	pseudonaja_textilis_21	Pseudonaja_textilis	1029	False	1028	1	2519	110	datasets
Lepidosauria	anolis_sagrei_5	Anolis_sagrei	1038	False	1037	1	4667	110	datasets
Lepidosauria	pituophis_catenifer_annectens_0	Pituophis_catenifer_annectens	1320	False	1319	1	2420	110	datasets
Lepidosauria	lacerta_agilis_18	Lacerta_agilis	1035	False	1034	1	2499	110	datasets
Lepidosauria	candoia_aspera_2	Candoia_aspera	1035	False	1034	1	2293	110	datasets
Lepidosauria	sphaerodactylus_townsendi_12	Sphaerodactylus_townsendi	1038	False	1037	1	2825	110	datasets
Lepidosauria	thamnophis_elegans_19	Thamnophis_elegans	1038	False	1037	1	2426	110	datasets
Lepidosauria	ahaetulla_prasina_7	Ahaetulla_prasina	1290	False	1289	1	2432	110	datasets
Lepidosauria	gekko_japonicus_25	Gekko_japonicus	1044	False	1043	1	2924	110	datasets
Lepidosauria	crotalus_tigris_15	Crotalus_tigris	1332	False	1331	1	3091	110	datasets
Lepidosauria	pogona_vitticeps_23	Pogona_vitticeps	1038	False	1037	1	2746	110	datasets
Lepidosauria	podarcis_raffonei_10	Podarcis_raffonei	1035	False	1034	1	2495	110	datasets
Lepidosauria	protobothrops_mucrosquamatus_24	Protobothrops_mucrosquamatus	1029	False	1028	1	3264	110	datasets
Lepidosauria	varanus_komodoensis_13	Varanus_komodoensis	1044	False	1043	1	2658	110	datasets
Lepidosauria	pantherophis_guttatus_17	Pantherophis_guttatus	1314	False	1313	1	2411	110	datasets
Lepidosauria	elgaria_multicarinata_webbii_3	Elgaria_multicarinata_webbii	1065	False	1064	1	2800	110	datasets
Lepidosauria	rhineura_floridana_4	Rhineura_floridana	1044	False	1043	1	2581	110	datasets
Lepidosauria	podarcis_muralis_20	Podarcis_muralis	1035	False	1034	1	2506	110	datasets
Lepidosauria	heteronotia_binoei_6	Heteronotia_binoei	1044	False	1043	1	3002	110	datasets
Lepidosauria	anolis_carolinensis_27	Anolis_carolinensis	1128	False	1127	1	4026	110	datasets
Lepidosauria	erythrolamprus_reginae_1	Erythrolamprus_reginae	171	False	170	1	2638	110	datasets
Lepidosauria	sceloporus_undulatus_14	Sceloporus_undulatus	1059	False	1058	1	2380	110	datasets
Lepidosauria	eublepharis_macularius_9	Eublepharis_macularius	1038	False	1037	1	2577	110	datasets
Lepidosauria	euleptes_europaea_8	Euleptes_europaea	1044	False	1043	1	2901	110	datasets
Lepidosauria	hemicordylus_capensis_11	Hemicordylus_capensis	993	False	992	1	2830	110	datasets
Lepidosauria	zootoca_vivipara_16	Zootoca_vivipara	1038	False	1037	1	2516	110	datasets
Testudinata	emys_orbicularis_2	Emys_orbicularis	1200	False	1058	142	1650	110	datasets
Testudinata	chelonoidis_abingdonii_9	Chelonoidis_abingdonii	1191	False	1049	142	1645	110	datasets
Testudinata	chrysemys_picta_bellii_14	Chrysemys_picta_bellii	1194	False	1052	142	1662	110	datasets
Testudinata	pelodiscus_sinensis_13	Pelodiscus_sinensis	1686	False	1046	640	1643	110	datasets
Testudinata	gopherus_evgoodei_10	Gopherus_evgoodei	1485	False	1184	301	1639	110	datasets
Testudinata	malaclemys_terrapin_pileata_3	Malaclemys_terrapin_pileata	1194	False	1052	142	1652	110	datasets
Testudinata	terrapene_triunguis_11	Terrapene_triunguis	1269	False	1058	211	1662	110	datasets
Testudinata	gopherus_flavomarginatus_4	Gopherus_flavomarginatus	1203	False	1061	142	1655	110	datasets
Testudinata	mauremys_mutica_6	Mauremys_mutica	1200	False	1058	142	1662	110	datasets
Testudinata	mauremys_reevesii_7	Mauremys_reevesii	1200	False	1058	142	1661	110	datasets
Testudinata	emydura_macquarii_macquarii_1	Emydura_macquarii_macquarii	1446	False	1223	223	1647	110	datasets
Testudinata	dermochelys_coriacea_8	Dermochelys_coriacea	1140	False	1061	79	1661	110	datasets
Testudinata	chelonia_mydas_12	Chelonia_mydas	1143	False	1064	79	1674	110	datasets
Testudinata	caretta_caretta_5	Caretta_caretta	1137	False	1058	79	1656	110	datasets
Testudinata	trachemys_scripta_elegans_0	Trachemys_scripta_elegans	1194	False	1052	142	1661	110	datasets
Crocodylia	alligator_sinensis_1	Alligator_sinensis	999	False	851	148	1497	110	datasets
Crocodylia	alligator_mississippiensis_0	Alligator_mississippiensis	1293	False	1145	148	1618	110	datasets
Aves	melopsittacus_undulatus_28	Melopsittacus_undulatus	1521	False	1004	517	1257	110	datasets
Aves	neopsephotus_bourkii_16	Neopsephotus_bourkii	1497	False	995	502	1245	110	datasets
Aves	cygnus_atratus_24	Cygnus_atratus	1032	False	1007	25	1257	110	datasets
Aves	haliaeetus_leucocephalus_39	Haliaeetus_leucocephalus	1029	False	1004	25	1375	110	datasets
Aves	phalacrocorax_carbo_11	Phalacrocorax_carbo	1029	False	1004	25	1345	110	datasets
Aves	camarhynchus_parvulus_29	Camarhynchus_parvulus	2355	False	995	1360	2456	110	datasets
Aves	taeniopygia_guttata_31	Taeniopygia_guttata	990	False	989	1	443	110	datasets
Aves	molothrus_aeneus_7	Molothrus_aeneus	993	False	992	1	745	110	datasets
Aves	rissa_tridactyla_20	Rissa_tridactyla	1209	False	1004	205	1388	110	datasets
Aves	pezoporus_flaviventris_15	Pezoporus_flaviventris	1572	False	1004	568	1328	110	datasets
Aves	grus_americana_19	Grus_americana	1029	False	1004	25	1659	110	datasets
Aves	caloenas_nicobarica_9	Caloenas_nicobarica	1185	False	1001	184	1245	110	datasets
Aves	aythya_fuligula_27	Aythya_fuligula	1047	False	1022	25	1227	110	datasets
Aves	aquila_chrysaetos_chrysaetos_32	Aquila_chrysaetos_chrysaetos	1029	False	1004	25	1375	110	datasets
Aves	haliaeetus_albicilla_3	Haliaeetus_albicilla	1029	False	1004	25	1378	110	datasets
Aves	strigops_habroptila_30	Strigops_habroptila	1461	False	1004	457	1317	110	datasets
Aves	astur_gentilis_22	Astur_gentilis	1029	False	1004	25	1393	110	datasets
Aves	anas_acuta_6	Anas_acuta	1113	False	1088	25	1346	110	datasets
Aves	ciconia_boyciana_44	Ciconia_boyciana	1029	False	1004	25	1459	107	datasets
Aves	vidua_chalybeata_21	Vidua_chalybeata	2505	True	986	1519	678	110	datasets
Aves	oxyura_jamaicensis_25	Oxyura_jamaicensis	1038	False	1013	25	1246	110	datasets
Aves	ammospiza_caudacuta_17	Ammospiza_caudacuta	1074	False	992	82	3942	110	datasets
Aves	apteryx_mantelli_38	Apteryx_mantelli	1545	False	1004	541	1359	110	datasets
Aves	phaenicophaeus_curvirostris_2	Phaenicophaeus_curvirostris	1893	False	1001	892	2155	110	datasets
Aves	lonchura_striata_35	Lonchura_striata	990	False	989	1	629	110	datasets
Aves	apteryx_rowi_34	Apteryx_rowi	1545	False	1004	541	1359	110	datasets
Aves	gallus_gallus_0	Gallus_gallus	1011	False	1004	7	1616	110	datasets
Aves	pezoporus_occidentalis_13	Pezoporus_occidentalis	1572	False	1004	568	1319	110	datasets
Aves	anser_cygnoides_47	Anser_cygnoides	1044	False	1019	25	1279	110	datasets
Aves	dromaius_novaehollandiae_33	Dromaius_novaehollandiae	1563	False	1010	553	1365	110	datasets
Aves	rhea_pennata_14	Rhea_pennata	1578	False	1010	568	1348	110	datasets
Aves	pezoporus_wallicus_18	Pezoporus_wallicus	1572	False	1004	568	1328	110	datasets
Aves	aphelocoma_coerulescens_4	Aphelocoma_coerulescens	1077	False	992	85	3626	110	datasets
Aves	catharus_ustulatus_26	Catharus_ustulatus	1227	False	986	241	3252	110	datasets
Aves	chroicocephalus_ridibundus_12	Chroicocephalus_ridibundus	1566	False	1004	562	1373	110	datasets
Aves	struthio_camelus_5	Struthio_camelus	1074	False	1010	64	1405	110	datasets
